0,-1
1,-1
2,-1
3,-1
4,20
5,1
6,-1
100,-1
101,-1
102,-1
103,-1
104,-1
105,-1
106,-1
107,-1
108,-1
